%%%%%%%%%%%%%%%%%%%%
%..................%
%..................%
%..................%
%..................%
%..................%
%..................%
%..................%
%..................%
%...A....**........%
/...A....**........%
%...A..............%
%..................%
%..................%
%..................%
%..................%
%..................%
%.......AAA........%
%..................%
%%%%%%%%%/%%%%%%%%%%
