%%%%%%%%%/%%%%%%%%%%
%..................%
%%%%%%.............%
%%%%............~~~%
%%%............~~~~%
%%...~~~~~%%.....~~%
%~~~~~~~~~%%%%...~~%
%~~~~~~~~~~~AA~~~~~%
%~~~~%%%~~%%..~~~~~%
%~~~~~%%~~%..~~~~~~%
/~~~~%%*~~%...~~~~~%
%.....%%%%%..%%%%~~%
%............%A%%.~%
%~~~~~~......~~~.~~%
%~~~~~~...~~~~~~..~%
%A~~~~~~~~~~~~...~~%
%%%%%%%%%~~~~~...~~%
%..~~~~~~~~~~~~....%
%.A%~~~~~~~~~~~....%
%%%%%%%%%/%%%%%%%%%%
