%%%%%%%%%%%%%%%%%%%%
%%%%%%%%%%%%~~~~~%%%
%%%%%%%%%%AA~~~~~~%%
%%%%%%%%%%%~~~~~~~~%
%%%%%%%%%%%%~~~~~~~%
%%%%%%%%%%%%%%%%%~~%
%~~%%%%%%%%%%%%%%~~%
%~~%%%%%%%%%%%%%%~~%
%~~~~%%%%%%%...~~~~%
%~~~~~%%%%%....~~~~%
/~~~~%%%%%%....~~~~/
%.......%%%..%%%%~~%
%............%%%%~~%
%~~~~~~~.....~~~~~~%
%~~~~~~~~~~~~~~~~~~%
%A~~~~~~~~~~~~~%%~~%
%%%%%%%%%~~~~~~%%~~%
%%%*..%%%~~~~~~~~~~%
%%%%.%~~~~~~~~~~~~A%
%%%%%%%%%/%%%%%%%%%%
