####################
####################
####################
####################
####################
####################
####################
####################
####################
####################
####################
####################
####################
####################
#%%#################
#*%#################
#*%#################
#*%#####%%%#########
#~~~~~AA~~~AA~~~~~~#
#########/##########
