####################
#AA.################
#AA.################
###.################
###.################
###..........#######
#####.######.#######
#####.######.#######
#####.####~..~~%####
#####.%%%%...#~~%###
/.....%%%%.~.#%~~~~/
#.####%%%%..~##%####
#.########.#########
#.########.#########
#..........#########
#####...~~~#########
#####...~~~#########
####...~~~~~~.*%####
##%...~~~~~~~~%#####
####################
