%%%%%%%%%/%%%%%%%%%%
%%%%%%%%..........A%
%%%%%%.............%
%..........%%%.....%
%.A%%%.....%%%%....%
%%%%...%%%%%%%%....%
%%%...%~~~~~%%%....%
%%...%~~~~~~~......%
%%....~~~~~~~......%
%.....~~~~~~~......%
/.....~~~~~~~....../
%.....~~~~~~~%%%...%
%....%%~~~~~%%%%...%
%.....%%%%%%%%%%...%
%.........%%%%%%%%.%
%...%%%.......%%%%.%
%..%%%.............%
%.%%%%%%%.%%%......%
%.....$%%...%%%*%%%%
%%%%%%%%%/%%%%%%%%%%
