%%%%%%%%%/%%%%%%%%%%
%~~~~~~~~~~~~~~~~%%%
%~~~%%%%%%%%%A~~~%%%
%~~%%%%%%%%%%~~~~%%%
%~~%%%%%%%%%%~~~~~~%
%~~%%%%%%%%%%%%%%~~%
%~~%%%%%%%%%%%%%%~~%
%~~%%%%%%%%%%%%%%~~%
%~~~~%%%%%%%%%%~~~~%
%~~~~~%%%%%%%%*~~~~%
/~~~~%%%%%%%%%%~~~~/
%~~%%%%%%%%%%%%%%~~%
%~~~~~~~~~~%%%%%%~~%
%~~~~~~~~~~~~~~~~~~%
%~~~~~~~~~~~~~~~~~~%
%~~~~~~~~~~~~~~%%~~%
%%%%%%%%%~~~~~~%%~~%
%%%%%%%%%~~~~~~~~~~%
%%%%%%%%%~~~~~~~~~A%
%%%%%%%%%/%%%%%%%%%%
