%%%%%%%%%/%%%%%%%%%%
%%%%%%%%...........%
%%%%%%.............%
%..........%%%.....%
%.A%%%.....%%%%####%
%%%%...%%%%%%%%####%
%%%...%~~~~~%%%....#
%%...%~~~~~~~A.....#
%%....~~~~~~~......#
%.....~~~~~~~......#
%.....~~~~~~~....../
%.....~~~~~~~%%%...%
%....%%~~~~~%%%%...%
%.....%%%%%%%%%%...%
%.........%%%%%%%%.%
%...%%%.......%%%%.%
%..%%%.............%
%.%%%%%%%.%%%......%
%.....*%%...%%%*%%%%
%%%%%%%%%/%%%%%%%%%%
