#########/##########
#.................%#
#...............%%%#
#.##.##.##.#..%%%###
#.##.##.##.#..%#####
#.##.##.##.#..%#####
#.##.##.##.#%%%%%%##
#.##.##.##.#########
#.##.##.##.#########
#.##.##.##.#########
#.%#.##.##.#########
#%%#.##.#%.#########
####.%#.#%%%########
###%....%%%%%%######
###%%##%%###########
####################
####################
####################
####################
####################
