####################
########*.........A#
######A............#
#..........~~~~~~~.#
#.A%%%~~~~~%%%%~~~.#
#%%%~~~%%%%%%%%~~..#
#%%~~~%~~~~~%%%~...#
##~~~%~~~~~~~###~..#
##....~~~~##~......#
#.....~~~~~~####...#
#.....~~%%#~####.../
#.....~~%%#~####...#
#....######~####...#
#....######.*#.....#
#.........####~~~~.#
#...%%%.......~~~~.#
#..%%%.............#
#.#######.###A.....#
#.....*##...########
#########/##########
