#########/##########
#A..#####.########.#
#.#.#####.########.#
#.#~~~*##.########.#
#.#~%%~##.########.#
#.#~~~~##.########.#
#.#.#.###.########.#
#.#.#.###.########.#
#......##.#####*~~A#
#%%.#####~~~.###.%%#
/........~%~.......#
#%%#################
####################
####################
####################
####################
####################
####################
####################
####################
