####################
#%~%################
#%~%################
#%~%################
#%~%################
#%~%%%%%%%%%%%%%%%##
#%~~~~~~~~~~~~~~*%##
#%~%%%%%%~%%%%%%%%##
#%~%####%~%#########
#%~%####%~%#####%%%#
/~~%####%~%#####%~~/
#%~%####%~%#####%~%#
#%~%####%~%#####%~%#
#%~%####%~%#####%~%#
#%~%####%~%#####%~%#
#%~%####%~%#####%~%#
#%~%####%~%#####%~%#
#%~%####%~%%%%%%%~%#
#%~%####%~~~~~~~~~%#
####################
