#########/##########
##%%%%%%..........A#
##################~#
#..........%%%%%%%~#
#.A%%%~~~~~%%%%%%%~#
####~~~%%~~~~~~~~~~#
###~~~%~~~~~%%%%%%~#
##~~~%~~~~~~~..%%%~#
##~~~~~~~~~~~....#~#
#~~~~~~~~~~~~..~~#~#
#~~~~~~~~~~~~~~~~#./
#~~~~~~~~~~~~%%%~~~#
#....%%~~~~~%%%~~%%#
#.....%%%%%%%%~~~%%#
#............~~~~~~#
#~~~%%%.......~~~~~#
#~~%%%*A.......~~~~#
#*##%%%%%#####..A..#
####################
####################
