####################
####################
####################
####################
####################
####################
#########~~~~#######
########~~~~~~######
#######~~~~~~~~#####
#######~%%%%~~~~####
/......~%%%%%~~~~###
#######~%%%%%~~~####
#######~~~~~~~~#####
########~~~~~~######
##########.#########
##########.#########
##########.#########
########*.A.*#######
########*.A.*#######
####################
