%%%%%%%%%/%%%%%%%%%%
%A............~~..*%
%......%%%%%...~%.%%
%....%%%%%%....~~~~%
%....%.........~~~~%
%....%AA%%%%....~~~%
%....%%%%........~~%
%%%%.%%%..........~%
%..................%
%..................%
/................../
%..................%
%~~~~~~~~..........%
%~~~~~~~~~~~.......%
%~~%%~~%~~~........%
%A~~...%~...%%%....%
%~%~*..~~~...%%%%..%
%~%~%~~%~~...%%%%%.%
%~~~~~~~~~.....%%%%%
%%%%%%%%%%%%%%%%%%%%
