####################
####################
####################
####################
####################
####################
###~~~~~~~~~%%%%%%##
##~~~~~~~~~~~~~%%%##
##~~~~%#####%~~~~~~%
#~~~~~#*...*#~~~~~~%
#~~~~~#..*...~~~~~~/
#~~~~~#*...*#%%%~~~%
#~~~~%#######%%~~~~%
#~~~~~%%%%%%%%#%#%#%
#AA~~~##############
####################
####################
####################
####################
####################
