#########/##########
########...#########
#######........#####
#..........%%%..~%%#
#A*A%%%....%%%%.~~%#
%%%%%%%%%%%%%%%..~~#
%%%~~%%~~~~~%%%....#
%%~~~%~~~~~~~%.....#
##...%~~~~~~~%.....#
#....~~~~~~~~~.....#
#....%~~~~~~~%.....#
#....%~~~~~~~%%%~..#
#....%%~~~~~%%%%~~.#
#*....%%%~%%%%%%~~~#
#..~~~...~%%%%%%%%~#
#.~~%%%~~~~~########
#~~%%%~~~~~~########
#*%%%%%%%~##########
########%~##########
#########/##########
