####################
####################
####################
###A........########
##...........#######
##....#......#######
##.A#........#######
##...........#######
##........#..#######
##.......#........./
##...........#######
##...........#######
##...#....#..#######
##A#.........#######
##...........#######
###.........########
####################
####################
####################
####################
