#########/##########
#................###
#.####.####.####.###
#.####.####.####.###
#.###........###.###
#.##..........##.###
#.##....$.....##.###
#.##..........##.###
#.###..A..A..###.###
#.####.####.####.###
/................../
#.####.####.####.###
#.####.####.####.###
#.####.####.####.###
#.####.####.####.###
#.####.####.####.###
#.####.####.####.###
#.####.####.####.###
#A................*#
####################
