#########/##########
#................###
#.####*####.####.###
#.####.####.####.###
#.####.####.####.###
#.####.####.####.###
#.####.####.####.###
#.####.####.####.###
#.####.####.####.###
#.####.####.####.###
/................../
#.####.####.####.###
#.####.####.####.###
#.####.####.####.###
#.####.####.####.###
#.####.####.####.###
#.####.####.####.###
#.####.####.####.###
#A..............A..#
#########/##########
