####################
####################
####################
#A##################
#*.................#
############......##
#.................##
#.##########....####
#.##########..######
/......A###......../
#########....#######
#####A....##...#####
##########.....#####
##########.#########
##########*#########
####################
####################
####################
####################
####################
