#########/##########
#########.##########
#########.##########
#########.##########
#########.##########
#########.##########
#########.##########
#########.##########
#########.##########
#########.##########
/.................A#
#########.##########
#########.##########
#########.##########
#########.##########
#########.##########
#########.##########
#########.##########
##*A.........A..####
####################
