####################
####################
####################
####################
#.###........###.###
#.##..........##.###
#.##....**....##.###
#.##..........##.###
#.###........###.###
#.####.####.####.###
/..................#
#.####.####.####.###
#.####.####.####.###
#.####.####.####.###
#.####.####.####.###
#.####.####.####.###
#.####.####.####.###
#.####.####.####.###
#A................*#
#########/##########
