#########/##########
#########.#.....####
#########.#......###
#########.#.......##
#########.#........#
#########.#........#
#########.#........#
#########.#........#
#########.#........#
########...........#
/................../
########...........#
#......#...........#
#A.....#...........#
#......#......##...#
#.....#.......##...#
#....#.............#
#...#............A.#
#...............A*A#
#########/##########
