####################
####################
###.............####
#########.##########
######.........#####
#####..##.####....##
#########.##########
#####.............##
#########.##########
#########.##########
####..............##
#########.##########
####.............###
#########.##########
######.............#
#########.##########
#*.............#####
#########.##########
##..............####
#########/##########
