#########/##########
#.........##########
#.#######.##########
#.###.###.##########
#.###*###....#######
#.###.###.##.#######
#.###.....##......##
#.###############.##
#...##.......*###..#
###............###.#
/.##.....0......##./
#.###..........###.#
#.####........####.#
#.#######.########.#
#....####.###......#
####...##.###.####.#
######........####.#
##.#####.#########.#
##.................#
####################
