#########/##########
#A.................#
#..................#
#..................#
#..................#
#..................#
#......#####.......#
#.....#######......#
#.....#######......#
/.....#######....../
#.....#######......#
#.....#######......#
#......#####.......#
#..................#
#..................#
#..................#
#..................#
#..................#
#*.................#
#########/##########
