#########/##########
#..................#
#.#######.########.#
#.#..............#A#
#.#.##.#.#.#.#.#.###
#.#..###########.###
#.#.###########..###
#*#..###########.###
###.###########..###
/....###########.###
###.###########..###
###..###########...#
###.###########..#.#
###..###########.#.#
###.###########..#.#
###.#.#.##.##.##.#.#
###.............##.#
##################.#
#*A................#
#########/##########
