#########/##########
#.A##..##.##..###..#
#..##....*##..###..#
#..##..##.##..###..#
#..##..##.##..###..#
#......##.....###..#
#..##..##.##..###..#
#...#..##..#..###..#
#..#...##..#.......#
#......##.....###..#
#..##..#...#..###../
#..##..##.##...*#..#
#..##..##..#..###..#
#..##..##.##..###..#
#.........#######..#
##.....##..........#
#*....#.##########.#
#..#..#.####..####.#
##A...#............#
#########/##########

