#########/##########
#..................#
#..................#
#..................#
#..................#
#..................#
#...############...#
#....A...*....A....#
#..................#
#..................#
#.....#######......#
#.....#######..##..#
#.....*#####...#####
#...##..........##A#
#................#.#
#..................#
#..................#
#..................#
#..............A...#
#########/##########
