####################
#.................A#
#..................#
#..................#
#..................#
#..................#
#......#####.......#
#.....#######......#
#.....#######......#
#.....#######......#
/.....#######....../
#.....#######......#
#......#####.......#
#..................#
#..................#
#..................#
#..................#
#..................#
#.................*#
#########/##########
