#########/##########
##......#.##....#.##
##.##.###.##.##.#..#
#####........##.#.##
#.....######.##.#.##
############.##...##
#A....######.##.#.##
#####........##.#.##
############.#######
######.#####.#.....#
##.....#####.#.###./
######.#####.#.....#
######.#####.#####.#
##.........#.#..##.#
####.#####.#.##.##.#
####.#####.#.##.##.#
####....##......##.#
#######.####.##.##.#
#######*####A##....#
####################
