####################
####################
####################
#A##################
#*.................#
############......##
#.................##
#.##########....####
#.##########..######
#########....#######
/................../
#####.....##...#####
#####.####......####
#####.####.####.####
#####A####*####.####
###############.####
###############.####
###############.A###
####################
####################
