####################
#...AA...........**#
#...AA.........##**#
##############.#####
#..................#
#..................#
#..A..............A#
#...#...#...#...#..#
#..................#
#..................#
#................../
#...#...#...#...#..#
#..................#
#..................#
#..................#
#...#...#...#...#..#
#............####..#
#............#######
#............#######
#########/##########
