####################
################.#.#
################.#.#
################.#.#
################.#.#
################.#.#
################.#.#
################.#.#
################.#.#
################.#.#
/..................#
##################.#
################A#.#
################.#.#
################.#.#
################.#.#
################.#.#
################.#.#
################...#
####################

