#########/##########
#########.##########
#########.##########
#########.##########
#########.##########
#########.##########
#########.##########
#########.##########
#:::::#&&.&&########
#........*........./
#:::::#&&.&&########
#########.##########
#########.##########
#########.##########
#########.##########
#########.##########
#########.##########
#########.##########
#########.##########
#########/##########
