####################
####################
####################
####################
####################
####################
####################
####################
#:::::#&&&&&########
#................../
#:::::#&&.&&###.####
#########.#####.:###
#########.##::#.#::#
#########.#&......*#
#########.##::#.#::#
#########.##::#.#::#
#########.##AA.....#
#########.##::#&#::#
#########.#####&####
#########/##########
