#########/##########
#########.##########
#########.##########
#########.##########
#:::::::#.#::::::::#
#*A................#
#:::::::#.#::::::::#
#########.##########
#:::::::#.#::::::::#
/...............&&&#
#:::::::#.#::::::::#
#########.##########
#########.##########
#########.##########
#########.#::::::::#
#####&&&..........A#
#####&&&..#::::::::#
####################
####################
####################
