####################
####################
##########..&&######
#########...&&######
#.......#.#::::::::#
#*.................#
#:::::::#.#::::::::#
#..................#
#:::::::#.#::::::::#
#................../
#:::::::#.#::::::::#
#..................#
#:::::::#.#::::::::#
#########.##########
####################
####################
####################
####################
####################
####################
