####################
####################
####################
####################
####################
####################
#######.&&&.########
######A......#######
#####.........######
/.......:::......../
#######.....##.#####
#########.####.#####
#########.####.#####
#########.####.#####
########:.:###.#####
#########:####.#####
#########.####.##*##
#########.####.##.##
#########.......&&##
#########/##########
