#########/##########
#.#::::##.##########
#.........##########
#.#::::#############
#.##################
#.##################
#.##################
#.##################
#.#................#
#.#................#
#...AAA.........***#
###.################
###.################
#::.::######&&&.&&&#
#.....&#####.......#
#::.::######::#.#::#
###.########.......#
###.########::#.#::#
###................#
####################
