####################
#.#::::#############
#......*############
#.#::::#############
#.##################
#.##################
#.##################
#.##################
#*................A#
#..................#
#..................#
###############.####
############&&...&&#
############.......#
############..&.&..#
############::#.#::#
############.......#
############::#.#::#
#########..........#
#########/##########
