####################
####################
####################
####################
####################
##::::::::::::::::##
#..................#
#.#::::::::::::::#.#
#.################.#
/................../
#.################.#
#.#::::::::::::::#.#
#..................#
#.#:::::::::::::::##
#..#################
#.....*#############
#...AAA#############
#.....*#############
####################
####################
