#########/##########
########......######
###........#..######
###.####...##...####
###.####...###....##
###.####...####...##
###.###.....###&&&##
###.##&......###&&##
###.#&&.......##&&&#
/...##########.....#
###.###.....########
###.####...#########
###.####:.:#########
#...####:.:#########
#.######:.:#########
#...&&###.##########
#.##&&###.##########
#.#######.##########
#.........##########
#########/##########
