####################
####################
####################
########&&&#########
#:::::::&&&::::::::#
#..................#
#:::::::#.#::::::::#
#########.##########
#:::::::#.#::::::::#
/...............&&&#
#:::::::#.#::::::::#
#########.##########
#########.##########
#########.##########
#########.#::::::::#
#####&&&..........A#
#####&&&..#::::::::#
####################
####################
####################
