#########/##########
####################
####################
########&&&#########
###::::#&&&#::::####
###.............####
###::::##.##::::####
###.......##########
###.################
/...################
###.###.....########
###.####...#########
###.::::#.###::::###
#...#............###
#.##::::#.###::::###
#...&&###.##########
#.##&&###.##########
#.#######.##########
#.........##########
####################
