#########/##########
#########.##########
#########.##########
#########.##########
#########..#########
#########.##########
#########.##########
#########.##########
#&&..............&&#
#&................&#
#&...............&&#
###############..###
############.......#
############.......#
############..&.&..#
############::#.#::#
############AA.....#
############::#.#::#
#########........AA#
#########/##########
