#########/##########
#.#::::##.##########
#.........##########
#.#::::#############
#.##################
#.##################
#.##################
#.##################
#.................A#
#................../
#..................#
###.################
###.################
#::.::######&&&.&&&#
#.....&#####.......#
#::.::######::#.#::#
###.########.......#
###.########::#.#::#
###................#
####################
