####################
#..................#
#..................#
#..................#
#..................#
#..................#
#..................#
#..................#
#..................#
#..................#
#................../
#..................#
#..................#
#..................#
#..................#
#..................#
#..................#
#..................#
#..................#
#########/##########
